20230707 3
20230709 3
20230710 3
20230711 3
20230712 3
20230714 3
20230715 3
20230730 3
20230731 3
20230801 3
20230802 3
20230803 3
20230804 3
20230805 3
20230806 3
20230807 3
20230808 3
20230809 3
20230810 3
20230811 3
20230812 3
20230813 3
20230815 3
20230816 3
20230817 3
20230818 3
20230819 3
20230820 3
20230821 3
20230822 3
20230823 3
20230824 3
20230825 3
20230826 3
20230827 3
20230828 3
20230829 3
20230830 3
20230831 3
20230901 3
20230902 3
20230903 3
20230904 3
20230905 3
20230906 3
20230907 3
20230908 3
20230909 3
20230910 3
20230911 3
20230912 3
20230913 3
20230914 3
20230915 3
20230916 3
20230917 3
20230918 3
20230919 3
20230920 1
20230921 1
20230922 1
20230923 1
20230924 1
20230925 1
20230926 1
20230927 1
20230928 1
20230929 1
20230930 1
20231001 1
20231002 1
20231003 1
20231005 1
20231007 1
20231008 1
20231009 1
20231010 1
20231011 1
20231012 1
20231013 1
20231014 1
20231015 1
20231016 1
20231017 1
20231018 1
20231019 1
20231020 1
20231021 1
20231022 1
20231023 1
20231024 1
20231025 1
20231026 1
20231027 1
20231028 1
20231029 1
20231030 1
20231031 1
20231101 1
20231102 1
20231103 1
20231104 1
20231105 1
20231106 1
20231107 1
20231108 1
20231109 1
20231110 1
20231111 1
20231112 1
20231113 1
20231114 1
20231115 1
20231116 1
20231117 1
20231118 1
20231120 1
20231121 1
20231122 1
20231123 1
20231124 1
20231125 1
20231126 1
20231127 1
20231128 1
20231129 1
20231130 1
20231201 1
20231202 1
20231203 1
20231204 1
20231205 1
20231206 1
20231207 1
20231208 1
