20230707 3
20230919 3
20230920 1
20240624 1
20240626 1
20240627 1
20240628 1
20240629 1
20240630 1
20240701 1
20240702 1
20240703 1
20240704 1
20240705 1
20240706 1
20240707 1
20240708 1
20240709 1
20240710 1
20240711 1
20240712 1
20240713 1
20240714 1
20240715 1
20240716 1
20240717 1
20240718 1
20240719 1
20240720 1
20240721 1
20240722 1
20240723 1
20240724 1
20240725 1
20240726 1
20240727 1
20240728 1
20240729 1
20240730 1
20240731 1
20240801 1
20240802 1
20240803 1
20240804 1
20240805 1
20240806 1
20240807 1
20240808 1
20240809 1
20240810 1
20240811 1
20240812 1
20240813 1
20240814 1
20240815 1
20240816 1
20240817 1
20240818 1
20240819 1
20240820 1
20240821 1
20240822 1
20240823 1
20240824 1
20240825 1
20240826 1
20240827 1
20240828 1
20240829 1
20240830 1
20240831 1
20240901 1
20240902 1
20240903 1
20240904 1
