20230707 3
20230709 3
20230710 3
20230711 3
20230712 3
20230714 3
20230715 3
20230730 3
20230731 3
20230801 3
20230802 3
20230803 3
20230804 3
20230805 3
20230806 3
20230807 3
20230808 3
20230809 3
20230810 3
20230811 3
20230812 3
20230813 3
20230815 3
20230816 3
20230817 3
20230818 3
20230819 3
20230820 3
20230821 3
20230822 3
20230823 3
20230824 3
20230825 3
20230826 3
20230827 3
20230828 3
20230829 3
20230830 3
20230831 3
20230901 3
20230902 3
20230903 3
20230904 3
20230905 3
20230906 3
20230907 3
20230908 3
20230909 3
20230910 3
20230911 3
20230912 3
20230913 3
20230914 3
20230915 3
20230916 3
20230917 3
20230918 3
20230919 3
20230920 1
20230921 1
20230922 1
20230923 1
20230924 1
20230925 1
20230926 1
20230927 1
20230928 1
20230929 1
20230930 1
20231001 1
20231002 1
20231003 1
20231005 1
20231007 1
20231008 1
20231009 1
20231010 1
20231011 1
20231012 1
20231013 1
20231014 1
20231015 1
20231016 1
20231017 1
20231018 1
20231019 1
20231020 1
20231021 1
20231022 1
20231023 1
20231024 1
20231025 1
20231026 1
20231027 1
20231028 1
20231029 1
20231030 1
20231031 1
20231101 1
20231102 1
20231103 1
20231104 1
20231105 1
20231106 1
20231107 1
20231108 1
20231109 1
20231110 1
20231111 1
20231112 1
20231113 1
20231114 1
20231115 1
20231116 1
20231117 1
20231118 1
20231120 1
20231121 1
20231122 1
20231123 1
20231124 1
20231125 1
20231126 1
20231127 1
20231128 1
20231129 1
20231130 1
20231201 1
20231202 1
20231203 1
20231204 1
20231205 1
20231206 1
20231207 1
20231208 1
20231209 1
20231210 1
20231211 1
20231212 1
20231213 1
20231214 1
20231215 1
20231216 1
20231217 1
20231218 1
20231219 1
20231220 1
20231221 1
20231222 1
20231223 1
20231224 1
20231225 1
20231226 1
20231227 1
20231230 1
20231231 1
20240101 1
20240102 1
20240103 1
20240104 1
20240105 1
20240106 1
20240107 1
20240108 1
20240109 1
20240110 1
20240111 1
20240112 1
20240113 1
20240114 1
20240115 1
20240116 1
20240117 1
20240118 1
20240119 1
20240120 1
20240121 1
20240122 1
20240124 1
20240125 1
20240126 1
20240127 1
20240128 1
20240129 1
20240130 1
20240131 1
20240201 1
20240202 1
20240203 1
20240204 1
20240205 1
20240206 1
20240207 1
20240208 1
20240209 1
20240210 1
20240211 1
20240212 1
20240213 1
20240214 1
20240215 1
20240216 1
20240217 1
20240218 1
20240219 1
20240220 1
20240221 1
20240222 1
20240223 1
20240224 1
20240225 1
20240226 1
20240227 1
20240228 1
20240229 1
20240301 1
20240302 1
20240303 1
20240304 1
20240305 1
20240306 1
20240307 1
20240308 1
20240309 1
20240310 1
20240311 1
20240312 1
20240313 1
20240314 1
20240315 1
20240316 1
20240317 1
20240318 1
20240319 1
20240320 1
20240321 1
20240322 1
20240323 1
20240324 1
20240325 1
20240326 1
20240327 1
20240328 1
20240329 1
20240330 1
20240331 1
20240401 1
20240402 1
20240403 1
20240404 1
20240405 1
20240406 1
20240407 1
20240408 1
20240409 1
20240410 1
20240411 1
20240412 1
20240413 1
20240415 1
20240416 1
20240417 1
20240418 1
20240419 1
20240420 1
20240421 1
20240422 1
20240423 1
20240424 1
20240425 1
20240426 1
20240427 1
20240428 1
20240429 1
20240430 1
20240501 1
20240503 1
20240504 1
20240505 1
20240506 1
20240507 1
20240508 1
20240509 1
20240510 1
20240511 1
20240512 1
20240513 1
20240514 1
20240515 1
20240516 1
20240517 1
20240518 1
20240519 1
20240520 1
20240521 1
20240522 1
20240523 1
20240524 1
20240525 1
20240526 1
20240527 1
20240528 1
20240529 1
20240530 1
20240531 1
20240601 1
20240602 1
20240603 1
20240604 1
20240605 1
